NO ./textures/red_wall.xpm
SO ./textures/red_wall.xpm
WE ./textures/eagle.xpm
EA ./textures/eagle.xpm

F 220,100,0
C 20,100,200

      1111111111111111
     100000000011000001
    10110000011100000001
   100100000000000000W001
  110000000011000000000001
 10000000001100000000001111
1111000000000000000000001001
 11110000000000000000000011
  110000001101010111000001
   1000000000000000110001
    10000000000000001101
     110000011101010111
      1111011111101011
       11111111111111
