1111
1001
1001
11111111
1001
1001
11111111
1001
1001
11111111
1001
1001
11111111
1001
1001
11111111
1001
1001
11111111
1001
1001
11111111
1001
1001
11111111
1001
1001
11111111
1001
1001
11111111
1001
1001
1111
