NO ./textures/red_wall.xpm
SO ./textures/red_wall.xpm
WE ./textures/red_wall.xpm
EA ./textures/red_wall.xpm

F 220,100,0
C 225,30,0

111111111111111111111111111
